1 1 1 1 1 1 1 1 1 1 8 8 12 8 12 8 8
3 0 0 0 0 0 0 0 0 1 8 0 0 0 0 0 8
3 0 0 0 0 0 0 2 0 1 8 0 0 0 0 0 8
3 0 0 0 0 0 0 0 0 9 0 0 0 0 0 0 12
3 0 0 0 0 0 0 0 0 1 8 0 0 0 0 0 8
3 0 0 2 0 0 0 0 0 1 8 0 0 0 0 0 8
3 0 0 0 0 0 0 0 0 1 12 0 0 0 0 0 12
3 0 0 0 0 0 0 0 0 1 8 0 0 0 0 0 8
3 3 3 3 3 3 0 0 0 1 8 0 0 0 0 0 8
1 1 1 1 1 1 0 0 0 1 12 0 0 0 0 0 12
3 0 0 0 0 0 0 0 0 1 8 0 0 0 0 0 8
3 0 0 0 0 0 0 0 0 1 8 8 8 9 8 8 8
3 0 0 0 2 0 0 0 0 1 13 13 13 0 13 13 13
3 0 4 0 0 0 0 0 0 1 13 0 0 0 0 0 13
3 0 0 0 0 0 0 0 0 1 14 0 0 0 0 0 14
3 0 0 0 4 0 0 0 1 1 13 0 0 0 0 0 13
3 0 0 0 0 0 0 0 1 1 13 0 0 0 0 0 13
3 0 4 0 0 0 0 0 0 1 14 0 0 0 0 0 14
3 0 0 0 0 0 0 2 0 1 13 0 0 0 0 0 13
3 0 0 0 0 0 0 0 0 1 13 0 0 0 0 0 13
3 0 0 0 0 0 0 0 0 1 14 0 0 0 0 0 14
3 0 4 4 0 0 0 0 0 1 13 0 0 0 0 0 13
3 0 0 0 0 0 0 0 0 1 13 0 0 0 0 0 13
3 0 0 0 0 0 0 0 0 9 0 0 0 0 0 0 13
3 1 5 1 1 1 1 1 1 1 13 11 10 9 10 11 13
7 7 0 7 7 7 7 7 7 7 1 1 1 0 1 1 1
7 0 0 0 0 0 0 0 0 7 1 0 0 0 0 0 1
7 0 0 0 0 0 0 0 0 7 1 0 0 0 0 0 1
7 7 7 7 7 0 0 0 0 5 0 0 0 0 0 0 1
7 0 0 0 0 0 0 0 0 7 3 0 0 0 0 0 1
7 0 0 0 0 0 0 0 0 7 3 0 0 0 0 0 1
7 7 7 7 7 7 7 7 7 7 3 3 3 3 3 3 1
